wwwwwwwwwwwwwwwwwwwwwwww
w                      w
w                      w
w                      w
w                      w
w       w              w
w       b              w
w       t              w
w                      w
w                      w
w                      w
w                      w
w                      w
w       w              w
w       b              w
w       t              w
w                      w
w                      w
w                      w
w                      w
w       s              w
w                      w
w                      w
w                      w
wwwwwwwwwwwwwwwwwwwwwwww
